#############
#         O #
#   P   #####
#           #
#######     #
#  O ##     #
#    ##     #
#           #
#        XX #
#        #  #
#############
