#######
#     ######
# X P      #
#         O#
###      ###
  #        #####
###         O  #
#   X          #
#              #
################
