#########
#      O#     #######
#       #     #     #
# X     #     # X   #
###     #######     #   
  #                O#    
###       P     #####
# X          ####
#            #
###########  ####
          #    O#
          #######
